let="let"
run="run"
pipe="pipe"
file="file"
use="use"
error="error"
log="log"
assert="assert"
foo="foo"
bar="bar"
baz="baz"
nl="\\n"
tab="\\t"
ret="\\r"
hex="\\x"
bin="\\b"
paren="()"
paren4="(\\1 \\2 \\3 \\4)"
paren4comma="(\\a, \\b, \\c, \\d, )"
eval="!"
stringify="\\"
dquote="\\""
squote="'"
raw="r#\\""
para="p#\\""
code="c#\\""
end="\\"#"
cat=".."
match="match"
lbrace="{"
rbrace="}"
lbracket="["
rbracket="]"
slice="1:1"
comment="#["
